64 20
#############
#...........#    ########
#...s...s...######......#
#.............2.........#
#...........######......#
#.....s..1..#    #......#
#..h.sss....#    #......#
#........1..#    #......#
#####.m.#####    ###..###
    #...#           #..#
    #...#           #..#
    #...#        ####..##
  ###...###      #......###################################
  #..@..r.#      #........................................#
  #.....r.#      #..............####......................#
  #.....r.#      #..............#  #......................#
  #...k...#      #..h...#########  #......................#
  #.......#      #......#          #......................#
  #.......#      #......#          #......................#
  #########       ######           ########################
